1010101010101010101010101010101010101010101010101010101010101010101010101010101010101010101010101010
1002000100010001000100010001000100010001000001101010010000010000010000010000000100000100000001000210
1000101010101000001010101010001010101010100000101010001010101010000010001010101010101000101010100010
1001101010101000001010101010001010101010100000101010001010101010001010001010101010101000101010100010
1000101001000000000000011010001010101010100000101010000000000000000010001010101010101000101010100010
1001101010101000001010101010000001000000000000000300000000000000000010000100000100010000010001000110
1000101010101000001010101010001010100010101010101010101010100003000010000000000000000000000000000010
1000000100010000000100000000001010100010101010101010101010100010100000000000000000000000000000000010
1001101010101000101010001010000001000000000001101010010000000010100000101010100000031010101010100010
1000101010101000101010011010000010100000101000101010000010100010100000101010100000001010101010100010
1001101010101000101010101010000010100000101000101010000010100010100000010000010000000000000100000010
1000101010101000101010101010000000000000000300101010000000000000000010101010101010100100000000000110
1001000100011000101010010000000300000000000000000000000000000000000010101010101010101010101010101010
1010101010001000101010001010101010001010101010000000101010101000000000000000000010101010101010101010
0000000000000000101010001010101010001000000000000000000000001000000010101010000010100000000000000000
0000000000000000000000001010101010011000000000000000000000001000000010101010000010100000000000000000
1010101010001010001010001010101010001010101010101010101010101000000000011010000000000000101010101010
1010101010001010001010001010101010000100000000000200000000000100000300001010000000000000101000000110
1001000000001010001010000000030000001010101010101010101010101000000000001010101010101010101000000010
1010101001101010011010001010101010001010101010101010101010101000000000001010101010101010101010100010
1010101000101010101010000001000100010000000001101010010000000100000100000000000000101010041010100010
1001000000000010101010001010101010100000000000101010000000000010101010100000100000101010001010100010
1000001010100010101010011010101010100100000000000200000000000110101010100000100000000010001000000010
1001000110100010101010000000000100000010101010101010101010100000000000000004100000000000000000000010
1010100010100001000100010000101000100010101010101010101010100000101010101010100000030000000000000010
1010100110100010101010101000101000100000000100101010010000000100000000000100000000000000000000000010
1001000000000010101010101000100100101010001000101010000010101010100001101010100010101010101010000010
1000001010101010101010101000101010101010001000101010000010101010100000101010100010101010101010000010
1002010001000100010001000100010001000100000100010001000001000100010001101010100000000001101010000210
1010101010101010101010101010101010101010101010101010101010101010101010101010101010101010101010101010
